NO textures/ha.xpm
SO textures/o-_1_.xpm
WE textures/text-_1_.xpm
EA textures/ha2.xpm

F    104,104,104
C   137,207,240
111111111111111111111111111111111111111
10000100000001000S01000100000000000001
10000000000001010101010100101000000001
10000000100001010101010100000001000001
10000100000001010000010000101000000001
10000000100001011111110000000000000001
10000000100000000000000000100001000001
10000000000001010101010100101000000001
10000000100001010101010100000001000001
10000100000001010000010000101000000001
10000000100001011011110000000000000001
10000000100000000000000000100001000001
11111111111111111111111111111111111111