NO textures/text_no.xpm
SO textures/one.xpm
WE textures/redbrick.xpm
EA textures/lleagle.xpm

F   223, 100, 109
C   137,207,240

111111111111111111111111111111111111111
10000000001100000000000000000000000001
10110000011100000000000000000000000001
10010000000000000000000000000000000001
111111111011000001110000000000000000011
100000000011000001110111111111111111111
11000000000000000000000010000000000001
11000000100000000000000100000000000001
11000000100001000000001000000000000001
10000000000000000000100000010000000001
10000001000000100010000000001000000001
110000011000000000001001000010000000001
11000000000000000100000000000100000001
11000001001110000000000100000000000001
10000001000011000001000100000100000001
10000000001010101000000000000001000001
11000000000000000000000000001000000001
11000000001000001000000100001000000001
11000000000000010000000001001000000001
10000000000100000000000100000000000001
10000000000000010000000010000001000001
11000001110101011111011110000011110001
1111011111101011011111010001000000N01
11111111111111111111111111111111111111